*    *        *      *                    *    *               *          *  *      ****** 
*    *  ***   *      *       ***          *    *  ***    ***   *          *  *          *  
****** *   *  *      *      *   *         *    * *   *  *      *       ****  *         *   
*    * ****   *      *      *   *         *    * *   *  *      *      *   *  *        *    
*    * *      *      *      *   *         * ** * *   *  *      *      *   *          *     
*    *  ****   **     **     ***           *  *   ***   *       **     ****  *      ****** 
                                                                                           
